type octile
height 30
width 34
mapTest
@........................@@@@@@@@@
.........................@@@@@@@@@
.........................@@@@@@@@@
.........................@@@@@@@@@
.........................@@@@@@@@@
.........................@@@@@@@@@
.........................@@@@@@@@@
.........................@@@@@@@@@
.........................@@@@@@@@@
@@@......................@@@@@@@@@
@@@......................@@@@@@@@@
@@@......................@@@@@@@@@
@@@......................@@@@@@@@@
@@@......................@@@@@@@@@
@@@......................@@@@@@@@@
@@@......................@@@@@@@@@
@@@......................@@@@@@@@@
@@@......................@@@@@@@@@
@@@......................@@@@@@@@@
@@@......................@@@@@@@@@
@@@......................@@@@@@@@@
@@@......................@@@@@@@@@
@@@......................@@@@@@@@@
@@@......................@@@@@@@@@
@@@......................@@@@@@@@@
@@@......................@@@@@@@@@
@@@......................@@@@@@@@@
@@@......................@@@@@@@@@
@@@......................@@@@@@@@@
@@@......................@@@@@@@@@
